111111111111111111111111111111111111111111111
101P11111111101011111010111110111111111111111
101000101000001010000010C0C0C0100010000000001
10C0C01010C0C0C010100000100010000000100000101
111111101111111010101110101011101111101111111
10C0C0C01000000010C0C01000100010E0100010C0101
101111111011111111111111111110111110111011101
10C0C0C0C010001000000010000000100000100010001
101111111110101010111010111111101111101110111
10000F0010001010101000101000100010C0C010C0C01
111111111111111111111111111111111111111111111