1111111111111
1111001101111
1PCC010101111
1000011101101
1E00011111101
1001011111101
1111111111111
