1111111111111
1111001101111
1PCC010101111
1000011101101
1E00011111101
10010111C0001
1111111111111
