11111111
10010001
10010001
10010001
10010101
10110001
11111111
