1111111111111111111111111111111111
1E0000000000000C00000C000100000001
1010C10100101100101001010G00010101
1010110010101010001001010000010101
1P0011110CG0C0000000000111000000C1
1000011000001000110000001000111101
10110000011000100000100000001C0001
1111111111111111111111111111111111
