1111111111111111111111111111111111
1E0000000000000C00000C000000000001
1010010100100000101001G100G0G1C101
1010010011101010001001110010110101
1P0000000C00C0000000CCC000000000C1
1111111111111111111111111111111111
